111111111111111111111111111111111111111111111111111
100000000000000000010000100C000C00000000000100000C1
1000000000000100000100000000C00100000000C0000000001
1000000000000000000000001000000100C0000000C00000001
100100C01010000000000000000000000000100000000C000C1
10000001000010000000000100C001000000000000100000001
1000000000000000100010000000010000100CC000000000001
100000010000000100000101000000000101C000000000C0001
100001000010C01000000000000000000C00000010000000001
110000000000010000000000000000001000C0000C0000C0001
10000100000000000000010000001000000001C000000000001
111C10CC0000000000000100001000000000000000000100011
10000000000000000000000010000C00C000000000000000001
1000000000001000000100000000000000100000C0000000011
1000000C000P00000000000000C00000101000E000000000001
111111111111111111111111111111111111111111111111111