1111111111
100100PC01
100E000001
1111000011
1001100001
1000000111
1000100001
1110000111
1111111111